Anasayfa                  = default.asp                     *
Forum                     = Forum
download                  = download.asp                    */
toplist                   = toplist.takvaonline.com         *
sizden gelenler           = sizden_gelenler.asp             -
Sitemize reklam verin     = reklam_verin.asp                *
ziyaretçi defteri         = ziyaretci_defteri               *           
E-Kart Servisi            = e-kart.asp                      *
Sitemizi Tavsiye Edin     = tavsiye_et.asp                  *
iletisim                  = iletisim.asp                    *                  
ilmihal                   = ilmihal.asp
Kuran-i Kerim             = kuran.asp
hadis bankasi             = hadis_bankasi.asp
islam tarihi              = islam_tarihi.asp
Fýkýh                     = fikih.asp
akaid                     = akaid.asp
lugat                     = lugat.asp
tasavvuf                  = tasavvuf.asp
dualar                    = dualar.asp
ozel gunler               = ozel_gunler.asp
sohbetler                 = sohbetler.asp
ilahiler                  = ilahiler.asp
kuran ziyafeti            = kuran_ziyafeti.asp
dini filmler              = dini_filmler.asp
Hadis-i Þerifler          = hadisler.asp
ezanlar                   = ezanlar.asp
uye ol                    = uye_ol.asp
sifremi unuttum           = sifremi_unuttum.asp
Kullanici Giris           = kayit_giris.asp
Kullanici Kayit           = Kull_kayit.asp
Bilgi Bankasý             = bilgi_bankasi.asp
Video Ve Mp3ler           = video_mp3.asp
Uye Bilgileri             = uye_duzenle.asp
Sistemden Çýk             = sistem_cikis.asp